7 25 2
BBBBBBBBBBBBBBBBBBBBBBBBB
B...................0...B
B..BBBBBBBBB.BBBBBBBBB..B
B.......................B
B..BBBBBBBBB.BBBBBBBBB..B
BC.....................1B
BBBBBBBBBBBBBBBBBBBBBBBBB
right
left
